##########
#        #
#  S  A  #
#        #
##########
