#################
#               #
#    S  ^ v  A  #
#               #
#################
