#################
#               #
#         v  S ^#
#               #
#  <      #######
#      >  #
#    A    #
#         #
###########
