#################
#               #
#      S        #
#               #
#       v       #
#      > <      #
#       ^       #
#              A#
#      A        #
#               #
#################
