#################
#               #
#      S        #
#               #
#              >#
#             > #
#            >  #
#           >   #
#          >    #
#         >     #
#        >      #
#       >       #
#      >        #
#     >         #
#    >          #
#   >           #
#  >            #
# >             #
#>              #
#<              #
# <             #
#  <            #
#   <           #
#    <          #
#     <         #
#      <        #
#       <       #
#        <      #
#         <     #
#          <    #
#           <   #
#            <  #
#             < #
#              <#
#               #
#      A        #
#               #
#################
